###    ######    ###
###      ##      ###
##     ##  ##     ##
#      ##  ##      #
##                ##
#####          #####
###### ##  ##  #####
 #     ######     #
      ########
    ############
    ############
      ########
##     ######     ##
###### ##  ## ######
#####          #####
##                ##
#   ## #    # ##   #
##   ##      ##   ##
###    #    #    ###
###    ######    ###